+-----------------------------------------------------------------------------------------------------------------------------------------+
|                                                                                                                                         |
|                                                                                                                                         |
|                                                                                                                                         |
|                                                                                                                                         |
|                                                                                                                                         |
|                                                                                                                                         |
|                                                                                                                                         |
|                                                                                                                                         |
|                                                                                                                                         |
|                                                                                                                                         |
|                                                                                                                                         |
|                                                                                                                                         |
|                                                                                                                                         |
|                                                                                                                                         |
|                                                                                                                                         |
|                                                                                                                                         |
|                                  ##   ##  ###    #   #        #      ###     ###    #####   ####     ###                                |
|                                   ## ##  ##  ##  ##  ##      ##     ##  ##  ##  ## ###     ##        ##                                 |
|                                    ###   ##  ##  ##  ##      ##     ##  ##  ##  ##  ####    ###      #                                  |
|                                    ###   ##  ##  ##  ##       #     ##  ##  ##  ##    ###  ##                                           |
|                                    ###    ###     ###          ###   ###     ###   #####    ####    #                                   |
|                                                                                                                                         |
|                                                                                                                                         |
|                                                                                                                                         |
|                                                                                                                                         |
|                                                                                                                                         |
|                                                                                                                                         |
|                                                                                                                                         |
|                                                                                                                                         |
|                                                                                                                                         |
|                                                                                                                                         |
|                                                                                                                                         |
|                                                                                                                                         |
|                                                                                                                                         |
|                                                                                                                                         |
|                                                                                                                                         |
|                                                                                                                                         |
|                                                                                                                                         |
|                                                                                                                                         |
|                                                                                                                                         |
|                                                                                                                                         |
|                                                                                                                                         |
|                                                                                                                                         |
|                                                                                                                                         |
+-----------------------------------------------------------------------------------------------------------------------------------------+
