+-----------------------------------------------------------------------------------------------------------------------------------------+
|                                                                                                                                         |
|                                                                                                                                         |
|                                                                                                                                         |
|                                                                                                                                         |
|                                                                                                                                         |
|                                                                                                                                         |
|                                                                                                                                         |
|###########                                                                                                                              |
|          /                                                                                                                              |
|_________/                                                                                                                               |
|                                                                                                                                         |
|                                                                                                                                         |
|                                                                                                                                         |
|           ############                                                                                                                  |
|            \________/                                                                                                                   |
|                                                                                                                                         |
|                                                                                                                                         |
|                                                                                                                                         |
|                              #####################################                                                                      |
|                               \_________________________________/                                                                       |
|                                                                                                                                         |
|                                                                                                                                         |
|                                                                                   ^^^^^^^^^^^^^^^^                                      |
|                                                                                   \______________/                                      |
|#############################                                                                                                            |
|                           /                                                                                                             |
|                          /                                                                                ########                      |
|                         |                                                                                                               |
|                         |     #############################                                                                             |
|                         |     |                            \                                                                            |
|                         |     |                             \                                                                           |
|                         |     |                              \                                                                          |
|            ####################                               \                                                                         |
|            |                                                   |                                                                        |
|           /                                                    |                                                                        |
|          /                                                     |                                                                        |
|##############################################                  |                                                                        |
|                                             |                  |                                                                        |
|                                             |                  |                                                                        |
|                                             |                  |                                                  ######################|
|########################################################################################                            | / / / / / / / / / /|
|/ / / / / / / / / / / / / / / / / / / / / / / / / / / / / / / / / / / / / / / / / / / /|~~~~~~~~~~~~~~~~~~~~~~~~~~~~|/ / / / / / / / / / |
| / / / / / / / / / / / / / / / / / / / / / / / / / / / / / / / / / / / / / / / / / / / |                            | / / / / / / / / / /|
|/ / / / / / / / / / / / / / / / / / / / / / / / / / / / / / / / / / / / / / / / / / / /|                            |/ / / / / / / / / / |
+-----------------------------------------------------------------------------------------------------------------------------------------+
