+-----------------------------------------------------------------------------------------------------------------------------------------+
|                                                                                                                                         |
|                                                                                                                                         |
|                                                                                                                                         |
|                                                                                                                                         |
|                                                                                                                                         |
|                                                                                                                                         |
|                                                                                                                                         |
|                                                                                                                                         |
|                                                                                                                                         |
|                                                                                                                                         |
|                                                                                                                                         |
|                                                                                                                                         |
|                                                          ###################                                                            |
|                                                           \_______________/                                                             |
|                                                                                                                                         |
|                                                                                                                                         |
|                                                                                            ^^^^^^^^^^^^^^^^^^^^^^^^^^^^^^^^             |
|                                                                                            \______________________________/             |
|                              #####################################                                                                      |
|                               \_________________________________/                                                                       |
|                                                                                                                                         |
|                                                                                                                                         |
|                                                                                                                         ################|
|                                                                                                                          \              |
|                                                                                                                           \             |
|                                                                                                                            \            |
|     ##########################                                                                                              \           |
|      /                      \                                                                                                \          |
|      |                      |                      #############################                                              \         |
|      |                      |                      /                           \                                               \        |
|      |                      |                     /                             \                                               \       |
|      |                      |                    /                               \                                               \      |
|      |                      |                   /          ############################################                           \     |
|      |                      |                  /           /                                          \                            \    |
|      |                      |                 /           /                                            \                            \   |
|      |                      |                 |          /                                              \                            \  |
|      |                      |                 |         /                                                \                            \ |
|      |                      |                 |        /                                                  \                            \|
|      |                      |                 |       /                                                    \                            |
|#####################################          |      /  ###############################                     \     ######################|
| / / / / / / / / / / / / / / / / / /|~~~~~~~~~~~~~~~~~~~~| / / / / / / / / / / / / / / |~~~~~~~~~~~~~~~~~~~~~~~~~~~~| / / / / / / / / / /|
|/ / / / / / / / / / / / / / / / / / |          |    /    |/ / / / / / / / / / / / / / /|                       \    |/ / / / / / / / / / |
| / / / / / / / / / / / / / / / / / /|          |   /     | / / / / / / / / / / / / / / |                        \   | / / / / / / / / / /|
|/ / / / / / / / / / / / / / / / / / |          |  /      |/ / / / / / / / / / / / / / /|                         \  |/ / / / / / / / / / |
+-----------------------------------------------------------------------------------------------------------------------------------------+
