+-----------------------------------------------------------------------------------------------------------------------------------------+
|                                                                                                                                         |
|                                                                                                                                         |
|                                                                                                                                         |
|                                                                                                                                         |
|                                                                                                                                         |
|                                                                                                                                         |
|                                                                                                                                         |
|                                                                                                                                         |
|                                                                                                                                         |
|                                                                                                                                         |
|                                                                                                                                         |
|                                                                                                                                         |
|                                                                                                                                         |
|                                                                                                                                         |
|                                                                                                                                         |
|                                                                                                                                         |
|                                                                                                                                         |
|                                                                                                                                         |
|                        ######################################                                                                           |
|                         \                                  /                                                                            |
|                          \________________________________/                         #############                                       |
|                                                                                      \_________/                                        |
|##########                                                                                                                               |
|          \                                                                                                                              |
|           \                                                                                                                             |
|            \                                                                                                                            |
|             \                                                                                                                           |
|              \                                                                                                                          |
|               \                                                                                                                         |
|                \                                                                                                                        |
|                 \                                                                                                                       |
|                  \                                                                                                                      |
|                   \                                                                                                                     |
|                    \                                                          ####                                                      |
|                     \                                                         | /|                                                      |
|                      \                                                        |/ |                                                      |
|                       \                                                       | /|       ###############                                |
|                        \                                          ########    |/ |       |/ / / / / / /|                                |
|                         \                                         | / / /|    | /|       | / / / / / / |                                |
|######################################      ########               |/ / / |    |/ |       |/ / / / / / /|       #########################|
| / / / / / / / / / / / / / / / / / / |      | / / /|      #####    | / / /|    | /|       | / / / / / / |       | / / / / / / / / / / / /|
|/ / / / / / / / / / / / / / / / / / /|~~~~~~| / / /|~~~~~~| / |~~~~|/ / / |~~~~|/ |~~~~~~~|/ / / / / / /|~~~~~~~|/ / / / / / / / / / / / |
| / / / / / / / / / / / / / / / / / / |      |/ / / |      |/ /|    | / / /|    | /|       |/ / / / / / /|       |/ / / / / / / / / / / / |
|/ / / / / / / / / / / / / / / / / / /|      | / / /|      | / |    |/ / / |    |/ |       | / / / / / / |       | / / / / / / / / / / / /|
+-----------------------------------------------------------------------------------------------------------------------------------------+
