+-----------------------------------------------------------------------------------------------------------------------------------------+
|                                                                                                                                         |
|                                                                                                                                         |
|                                                                                                                                         |
|                                                                                                                                         |
|                                                                                                                                         |
|                                                                                                                                         |
|                                                                                                                                         |
|                                                                                                                                         |
|                                                                                                                                         |
|                                                                                                                                         |
|                                                                                                                                         |
|                                                                                                                                         |
|                                                                                                                                         |
|                                                                                                                                         |
|                                                                                                                                         |
|                                                                                                                                         |
|                                                                                                                                         |
|                                                                                                                                         |
|                                                                                                                                         |
|                                                                                                                                         |
|                                                                                                                                         |
|                                                                                                                                         |
|                                                                                                                                         |
|                                                                                                                                         |
|                                                                                                                                         |
|                                                                                                                                         |
|                                                                                                                                         |
|                                                                                                                                         |
|                                                                                                                                         |
|                                                                                                                                         |
|                                                                                                                                         |
|                                                                                                                                         |
|                                                                                                                                         |
|                                                                                                                                         |
|                                                                                                                                         |
|                                                                                                                                         |
|                                                                                                                                         |
|                                                                                                                                         |
|                                                                                                                                         |
|############                                                                                                                 ############|
| / / / / / |~~~~~~~~~~~~~~~~~~~~~~~~~~~~~~~~~~~~~~~~~~~~~~~~~~~~~~~~~~~~~~~~~~~~~~~~~~~~~~~~~~~~~~~~~~~~~~~~~~~~~~~~~~~~~~~~~| / / / / / |
|/ / / / / /|                                                                                                                 |/ / / / / /|
| / / / / / |                                                                                                                 | / / / / / |
|/ / / / / /|                                                                                                                 |/ / / / / /|
+-----------------------------------------------------------------------------------------------------------------------------------------+
