+-----------------------------------------------------------------------------------------------------------------------------------------+
|                                          #     #                                       #     #                                          |
|                                          #     #                                       #     #                                          |
|                                          #     #                                       #     #                                          |
|                                          #     #                                       #     #                                          |
|                                          #     #                                       #     #                                          |
|                              # # # # # # # # # # # # # # # # # # # # # # # # # # # # # # # # # # # # # # #                              |
|                               ###########################################################################                               |
|                                #########################################################################                                |
|                                 #     #                                                         #     #                                 |
|                                 #     #                                                         #     #                                 |
|                                 #     #                                                         #     #                                 |
|                                 #     #                                                         #     #                                 |
|                                 #     #                                                         #     #                                 |
|                                 #     #                                                         #     #                                 |
|                                 #     #                                                         #     #                                 |
|                                 #     #                                                         #     #                                 |
|               <# # # # # # # # # # # # # # # # # # # # # # # # # # # # # # # # # # # # # # # # # # # # # # # # # # # # #                |
|                <#######################################################################################################                 |
|                 <#####################################################################################################                  |
|                  <#     #>                                                                                    #     #                   |
|                  <#     #>                                                                                    #     #                   |
|                  <#     #>                                                                                    #     #                   |
|                  <#     #>                                                                                    #     #                   |
|                  <#     #>                                                                                    #     #                   |
|                  <#     #>                                                                                    #     #                   |
|                  <#     #>                                                                                    #     #                   |
|                  <#     #>                                                                                    #     #                   |
|                  <#     #>                             <##^^^^^^^^^^^^^^^^^^^^^##                             #     #                   |
|                  <#     #>                              <# # # # # # # # # # # #                              #     #                   |
|                  <#     #>                             <#########################                             #     #                   |
|                  <#     #>                             <# # #+------+------+####                              #     #                   |
|                  <#     #>                               < # |===={ | }====|###                               #     #                   |
|                  <#     #>                             <# # #|      |      |####                              #     #                   |
|                  <#     #>                               < # |      |      |###                               #     #                   |
|                  <#     #>                             <# # #|===={ | }====|####                              #     #                   |
|                  <#     #>                               < # |      |      |###                               #     #                   |
|                  <#     #>                             <# # #|      |      |####                              #     #                   |
|                  <#     #>                               < # |===={ | }====|###                               #     #                   |
|                  <#     #>                             <# # #|      |      |####                              #     #                   |
|#########################################################################################################################################|
| / / / / / / / / / / / / / / / / / / / / / / / / / / / / / / / / / / / / / / / / / / / / / / / / / / / / / / / / / / / / / / / / / / / / |
|/ / / / / / / / / / / / / / / / / / / / / / / / / / / / / / / / / / / / / / / / / / / / / / / / / / / / / / / / / / / / / / / / / / / / /|
| / / / / / / / / / / / / / / / / / / / / / / / / / / / / / / / / / / / / / / / / / / / / / / / / / / / / / / / / / / / / / / / / / / / / |
|/ / / / / / / / / / / / / / / / / / / / / / / / / / / / / / / / / / / / / / / / / / / / / / / / / / / / / / / / / / / / / / / / / / / / /|
+-----------------------------------------------------------------------------------------------------------------------------------------+
