+-----------------------------------------------------------------------------------------------------------------------------------------+
|                                                                                                                                         |
|                                                                                                                                         |
|                                                                                                                                         |
|                                                                                                                                         |
|                                                                                                                                         |
|                                                                                                                                         |
|                                                                                                                                         |
|                                                                                                                                         |
|                                                                                                                                         |
|                                                                                                                                         |
|                                                                                                                                         |
|                                                                                                                                         |
|                                                                                                                                         |
|                                                                                                                                         |
|                                                                                                                                         |
|                                                                                                                                         |
|                                  ##   ##  ###    #   #         #       #     ##   #    #      ###                                       |
|                                   ## ##  ##  ##  ##  ##      ##         ##   #   # #    #     ##                                        |
|                                    ###   ##  ##  ##  ##      ##    #    ##      ##  ##   #    #                                         |
|                                    ###   ##  ##  ##  ##       ## ## ## ##   #   ##     ###                                              |
|                                    ###    ###     ###           #     #     #     #     #    #                                          |
|                                                                                                                                         |
|                                                                                                                                         |
|                                                                                                                                         |
|                                                                                                                                         |
|                                                                                                                                         |
|                                                                                                                                         |
|                                                                                                                                         |
|                                                                                                                                         |
|                                                                                                                                         |
|                                                                                                                                         |
|                                                                                                                                         |
|                                                                                                                                         |
|                                                                                                                                         |
|                                                                                                                                         |
|                                                                                                                                         |
|                                                                                                                                         |
|                                                                                                                                         |
|                                                                                                                                         |
|                                                                                                                                         |
|                                                                                                                                         |
|                                                                                                                                         |
|                                                                                                                                         |
|                                                                                                                                         |
+-----------------------------------------------------------------------------------------------------------------------------------------+